XXXXXXXXXXXXXXXXXXXXXXXXXXXXXXXXX
X               X               X
X XXXXXXXXXXXXX X XXXXXXXXXXXXX X
X X           X X X           X X
X X XXXXXXXXX X X X XXXXXXXXX X X
X X X       X X X X X       X X X
X X X XXXXX X X X X X XXXXX X X X
X X X X   X X X X X X X   X X X X
X X X X X X X X X X X X X X X X X
X X X X XXX X X X X X X XXX X X X
X X X X     X X X X X X     X X X
X X X XXXXXXX X X X X XXXXXXX X X
X X X         X X X X         X X
X X XXXXXXXXXXX X X XXXXXXXXXXX X
X X             X X             X
X XXXXXXXXXXXXXXX XXXXXXXXXXXXXXX
X                               X
XXXXXXXXXXXXXXXXXXXXXXXXXXXXXXXXX
start 8, 3